6
Room 1:
3 57 57 57 152 153 57 57 57 4
76 6 6 6 6 6 6 6 6 77
76 6 6 6 6 6 6 6 6 77
76 6 6 6 6 6 6 6 6 77
221 6 6 6 6 6 6 6 6 77
240 6 6 6 6 167 6 6 6 77
76 6 6 6 6 6 6 6 6 77
76 6 6 6 6 6 6 6 6 77
76 6 6 6 6 6 6 6 6 77
22 78 78 78 78 78 78 78 78 23
Doors:
2
left 2
top 3
Enemies:
2
Skeleton 2 1 2 1
Mage 6 5 4 1
Items:
1
Chest 7 2 Sword

Room 2:
3 57 57 57 57 57 57 57 57 4
76 6 6 6 6 6 6 6 6 77
76 6 6 6 6 6 6 6 6 77
76 6 6 6 6 6 6 6 6 77
221 6 6 6 6 6 6 6 6 175
240 6 6 6 6 6 6 6 6 194
76 6 6 6 6 6 6 6 6 77
76 6 6 6 6 6 6 6 6 77
76 6 6 6 6 6 6 6 6 77
22 78 78 78 78 78 78 78 78 23
Doors:
2
left 4
right 1
Enemies:
2
Skeleton 2 1 2 1
Mage 6 5 4 1
Items:
1
Chest 7 2 Ring
NPCs:
1
Pug 3 7

ShopRoom 3:
3 57 57 57 57 57 57 57 57 4
76 6 6 6 6 6 6 6 6 77
76 6 6 6 6 6 6 6 6 77
76 6 6 6 6 6 6 6 6 77
76 6 6 6 6 6 6 6 6 77
76 6 6 6 6 6 6 6 6 77
76 6 6 6 6 6 6 6 6 77
76 6 6 6 6 6 6 6 6 77
76 6 6 6 6 6 6 6 6 77
22 78 78 78 140 141 78 78 78 23
Doors:
1
bottom 1
Items:
4
Ring 5
Sword 15
HealthPotion 10
Axe 20
NPCs:
1
Vendor 7 3

Room 4:
3 57 57 57 155 156 57 57 57 4
76 6 6 6 6 6 6 6 6 77
76 6 6 6 6 6 6 6 6 77
76 6 6 6 6 6 6 6 6 77
76 6 6 6 6 6 6 6 6 175
76 6 6 6 6 6 6 6 6 194
76 6 6 6 6 6 6 6 6 77
76 6 6 6 6 6 6 6 6 77
76 6 6 6 6 6 6 6 6 77
22 78 78 78 178 179 78 78 78 23
Doors:
3
top 6
right 2
bottom 5
Enemies:
2
Skeleton 2 1 2 1
Mage 6 5 4 1
Items:
1
Chest 7 2 Axe

Room 5:
3 57 57 57 116 117 57 57 57 4
76 6 6 6 6 6 6 6 6 77
76 6 6 6 6 6 6 6 6 77
76 6 6 6 6 6 6 6 6 77
76 6 6 6 6 6 6 6 6 77
76 6 6 6 6 6 6 6 6 77
76 6 6 6 6 6 6 6 6 77
76 6 6 6 6 6 6 6 6 77
76 6 6 6 6 6 6 6 6 77
22 78 78 78 78 78 78 78 78 23
Doors:
1
top 4
Items:
1
Key 4 4
NPCs:
1
Penguin 2 7

BossRoom 6:
3 57 57 57 57 57 57 57 57 4
76 6 6 6 6 6 6 6 6 77
76 6 6 6 6 6 6 6 6 77
76 6 6 6 6 6 6 6 6 77
76 6 6 6 6 6 6 6 6 77
76 6 6 6 6 6 6 6 6 77
76 6 6 6 6 6 6 6 6 77
76 6 6 6 6 6 6 6 6 77
76 6 6 6 6 6 6 6 6 77
22 78 78 78 178 179 78 78 78 23
Doors:
1
bottom 4
Enemies:
1
Arachne 1 1 10 1

Player:
Current room: 1 4 4
Characteristics: 3 3 1
Inventory:
Gold: 10
Keys: 1
Ring





